{
    "map": [
        ["#", "#", "#", "#", "#", "#", "#", "#", "#", "#", "#", "#", "#", "#", "#", "#", "#", "#", "#", "#", "#", "#", "#", "#", "#", "#", "#", "#", "#", "#", "#", "#"],
        ["#", " ", " ", " ", " ", " ", " ", " ", "B", " ", " ", " ", " ", " ", " ", " ", " ", " ", " ", " ", " ", " ", " ", " ", " ", " ", " ", " ", " ", " ", " ", "#"],
        ["#", " ", "#", "#", "#", " ", "#", "#", "#", " ", "#", "#", "#", "#", "C", "C", "#", "#", "#", "#", "#", "#", "#", "#", "#", "#", "#", "#", "#", "#", " ", "#"],
        ["#", " ", "#", " ", " ", " ", " ", " ", "#", " ", "#", " ", " ", " ", " ", " ", " ", " ", " ", " ", " ", " ", " ", " ", " ", " ", " ", " ", " ", "B", " ", "#"],
        ["#", " ", "#", " ", " ", "#", " ", " ", "#", " ", "#", " ", " ", "B", " ", " ", " ", " ", " ", " ", " ", "#", "#", "#", " ", " ", "#", "#", "#", "#", " ", "#"],
        ["#", " ", "#", " ", " ", "#", " ", " ", "#", " ", "#", " ", " ", "B", " ", "#", "#", "#", "#", " ", " ", "#", " ", " ", " ", " ", " ", " ", " ", "C", " ", "#"],
        ["#", " ", "C", " ", " ", "#", " ", " ", "#", " ", "#", " ", " ", "B", " ", " ", " ", " ", "B", " ", " ", "#", " ", " ", " ", " ", " ", "#", "#", "#", " ", "#"],
        ["#", " ", "C", " ", " ", " ", " ", " ", "#", " ", "#", " ", " ", "#", " ", "#", " ", " ", "B", " ", " ", "#", " ", " ", " ", " ", " ", " ", " ", "C", " ", "#"],
        ["#", " ", "#", " ", "#", "#", "#", "#", "#", " ", " ", " ", " ", "#", " ", "#", " ", "#", "B", " ", " ", "#", "#", "#", "B", "B", "B", "#", "#", "#", " ", "#"],
        ["#", " ", "#", " ", "#", " ", " ", " ", " ", " ", " ", " ", " ", "#", " ", "#", " ", " ", " ", " ", " ", "#", " ", " ", " ", "B", " ", " ", " ", "#", " ", "#"],
        ["#", " ", "#", " ", "#", "#", "#", "#", "#", "#", "#", "#", "#", "#", " ", "#", "#", "#", "#", " ", " ", "#", " ", " ", " ", "#", " ", " ", " ", "#", " ", "#"],
        ["#", " ", "#", " ", " ", " ", "C", " ", " ", " ", " ", " ", " ", "b", "A", " ", " ", " ", " ", " ", " ", "#", " ", " ", " ", "#", " ", " ", "a", "A", " ", "#"],
        ["#", " ", "#", " ", "#", "#", "#", "B", "B", "#", "#", "#", "#", "#", " ", "#", "#", "#", "#", " ", " ", "#", "#", "#", "#", "#", "#", "#", "A", "A", " ", "#"],
        ["#", " ", "#", " ", " ", "h", "C", " ", " ", "#", " ", "F", "F", "A", " ", "#", " ", " ", " ", " ", " ", " ", " ", " ", " ", "#", " ", "C", " ", "A", " ", "#"],
        ["#", " ", "#", " ", " ", " ", "#", " ", " ", "A", " ", "F", "F", "A", " ", "#", " ", "#", " ", " ", " ", " ", "#", " ", " ", " ", " ", "#", " ", "#", " ", "#"],
        ["#", " ", "#", "#", "#", "#", "#", " ", " ", "#", "#", "#", "#", "#", " ", "#", "#", "#", "#", " ", " ", "#", "#", "#", "#", "#", "#", "#", "#", "#", " ", "#"],
        ["#", " ", " ", " ", " ", " ", " ", " ", " ", " ", " ", " ", " ", " ", " ", " ", " ", " ", " ", " ", " ", "B", "c", " ", " ", " ", " ", " ", " ", " ", " ", "#"],
        ["#", "#", "#", "#", "#", "#", "#", "#", "#", "#", "#", "#", "#", "#", "#", "#", "#", "#", "#", "#", "#", "#", "#", "#", "#", "#", "#", "#", "#", "#", "#", "#"]
    ]
}