{
    "map": [
        ["#", "#", "#", "#", "#", "#", "#", "#", "#", "#", "#", "#", "#", "#", "#", "#"],
        ["#", "a", " ", " ", " ", " ", "b", "#", " ", " ", " ", " ", "A", " ", " ", "#"],
        ["#", "#", "#", "#", "#", "c", "#", "#", " ", "#", "#", "#", "#", " ", " ", "#"],
        ["#", " ", " ", " ", " ", " ", " ", "#", "B", "#", "F", "A", "#", " ", " ", "#"],
        ["#", " ", " ", " ", " ", " ", " ", "#", " ", "#", "#", " ", "#", " ", " ", "#"],
        ["#", " ", " ", " ", " ", " ", " ", "#", " ", " ", "#", " ", "#", " ", " ", "#"],
        ["#", " ", " ", " ", " ", " ", " ", "#", "#", " ", "#", " ", "#", " ", " ", "#"],
        ["#", " ", " ", " ", " ", " ", " ", "C", " ", " ", "#", " ", " ", " ", " ", "#"],
        ["#", "#", "#", "#", "#", "#", "#", "#", "#", "#", "#", "#", "#", "#", "#", "#"]
    ]
}