{
    "map": [
        ["#", "#", "#", "#", "#", "#", "#", "#", "#", "#", "#", "#", "#", "#", "#", "#", "#", "#", "#", "#", "#", "#", "#", "#", "#", "#", "#", "#", "#", "#", "#", "#"],
        ["#", " ", " ", " ", " ", " ", " ", " ", "B", " ", " ", " ", " ", " ", " ", " ", " ", " ", " ", " ", " ", " ", " ", " ", " ", " ", " ", " ", " ", " ", " ", "#"],
        ["#", " ", "#", "#", "#", " ", "#", "#", "#", " ", "#", "#", "#", "#", "C", "C", "#", "#", "#", "#", "#", "#", "#", "#", "#", "#", "#", "#", "#", "#", " ", "#"],
        ["#", " ", "#", " ", " ", " ", " ", " ", "#", "d", "#", "p", " ", " ", " ", " ", " ", " ", " ", " ", " ", " ", " ", " ", " ", " ", " ", " ", " ", "B", " ", "#"],
        ["#", " ", "#", " ", " ", "#", " ", " ", "#", "d", "#", " ", " ", "B", " ", " ", " ", " ", " ", " ", " ", "#", "#", "#", "d", "d", "#", "#", "#", "#", " ", "#"],
        ["#", " ", "#", " ", " ", "#", " ", " ", "#", " ", "#", " ", " ", "B", " ", "#", "#", "#", "#", "d", "d", "#", " ", " ", " ", " ", " ", " ", "h", "C", " ", "#"],
        ["#", " ", "C", " ", " ", "#", " ", " ", "#", " ", "#", " ", " ", "B", " ", " ", " ", " ", "B", " ", " ", "#", " ", " ", " ", " ", " ", "#", "#", "#", " ", "#"],
        ["#", " ", "C", " ", " ", " ", " ", " ", "#", " ", "#", " ", " ", "#", " ", "#", " ", " ", "B", " ", " ", "#", " ", " ", " ", " ", " ", " ", "h", "C", " ", "#"],
        ["#", " ", "#", " ", "#", "#", "#", "#", "#", " ", " ", " ", " ", "#", " ", "#", " ", "#", "B", " ", " ", "#", "#", "#", "B", "B", "B", "#", "#", "#", " ", "#"],
        ["#", " ", "#", " ", "#", "h", " ", " ", " ", " ", " ", " ", " ", "#", " ", "#", " ", " ", " ", " ", " ", "#", "h", " ", "d", "B", "d", " ", "d", "#", " ", "#"],
        ["#", " ", "#", " ", "#", "#", "#", "#", "#", "#", "#", "#", "#", "#", " ", "#", "#", "#", "#", " ", " ", "#", " ", " ", " ", "#", " ", "d", " ", "#", " ", "#"],
        ["#", " ", "#", " ", " ", " ", "C", " ", " ", "d", " ", " ", " ", "b", "A", " ", " ", " ", " ", " ", " ", "#", "p", " ", "h", "#", "d", " ", "a", "A", " ", "#"],
        ["#", " ", "#", " ", "#", "#", "#", "B", "B", "#", "#", "#", "#", "#", " ", "#", "#", "#", "#", " ", " ", "#", "#", "#", "#", "#", "#", "#", "A", "A", " ", "#"],
        ["#", " ", "#", " ", " ", "h", "C", "p", " ", "#", "d", "F", "F", "A", " ", "#", " ", " ", " ", " ", " ", " ", " ", " ", " ", "#", " ", "C", " ", "A", " ", "#"],
        ["#", " ", "#", " ", " ", " ", "#", " ", " ", "A", "d", "F", "F", "A", " ", "#", " ", "#", " ", " ", " ", " ", "#", " ", " ", " ", " ", "#", "h", "#", " ", "#"],
        ["#", " ", "#", "#", "#", "#", "#", " ", " ", "#", "#", "#", "#", "#", " ", "#", "#", "#", "#", " ", " ", "#", "#", "#", "#", "#", "#", "#", "#", "#", " ", "#"],
        ["#", " ", " ", "p", "p", "p", " ", " ", " ", " ", " ", " ", " ", " ", " ", " ", " ", " ", " ", " ", " ", "B", "c", " ", " ", " ", " ", " ", " ", " ", " ", "#"],
        ["#", "#", "#", "#", "#", "#", "#", "#", "#", "#", "#", "#", "#", "#", "#", "#", "#", "#", "#", "#", "#", "#", "#", "#", "#", "#", "#", "#", "#", "#", "#", "#"]
    ]
}