{
    "map": [
        ["#", "#", "#", "#", "#", "#", "#", "#", "#", "#", "#", "#", "#", "#", "#", "#", "#", "#", "#", "#", "#", "#", "#", "#", "#", "#", "#", "#", "#", "#", "#", "#"],
        ["#", "d", "h", "#", "d", "b", "#", "h", "p", "d", "p", "A", "B", "A", "d", "h", "h", "d", "A", "B", "p", "p", "d", "p", "h", "#", "h", "d", "#", "h", " ", "#"],
        ["#", "h", "#", "#", "p", "d", "#", "#", "p", "p", "p", "#", "p", "B", "A", "d", "d", "A", "B", "p", "#", "p", "p", "p", "#", "#", "d", "p", "#", "#", " ", "#"],
        ["#", "d", "#", "C", "C", "C", "C", "#", "#", "#", "#", "#", "C", "C", "B", "A", "A", "B", "C", "C", "#", "#", "#", "#", "#", "A", "A", "A", "A", "#", " ", "#"],
        ["#", "h", " ", " ", " ", " ", " ", " ", " ", " ", " ", " ", " ", " ", " ", "B", "B", " ", " ", " ", " ", " ", " ", " ", " ", " ", " ", " ", " ", " ", " ", "#"],
        ["#", " ", " ", " ", " ", " ", " ", " ", " ", " ", " ", " ", " ", " ", " ", " ", " ", " ", " ", " ", " ", " ", " ", " ", " ", " ", " ", " ", " ", " ", " ", "#"],
        ["#", " ", "#", "p", " ", " ", "p", "#", "#", "#", "#", "#", "C", "C", "B", "C", "C", "B", "C", "C", "#", "#", "#", "#", "#", "p", " ", " ", "p", "#", "A", "#"],
        ["#", " ", "#", "#", " ", " ", "#", "#", "d", "d", "d", "#", " ", " ", "B", " ", " ", "B", " ", " ", "#", "F", "d", "d", "#", "#", "A", "A", "#", "#", " ", "#"],
        ["#", " ", " ", " ", " ", " ", "B", "d", "d", "d", "a", "#", " ", " ", "B", " ", " ", "B", " ", " ", "#", "F", "d", "d", "d", "d", " ", " ", " ", " ", " ", "#"],
        ["#", " ", " ", " ", " ", " ", "B", "d", "d", "d", "h", "#", " ", " ", "B", " ", " ", "B", " ", " ", "#", "F", "d", "d", "d", "d", " ", " ", " ", " ", " ", "#"],
        ["#", " ", "#", "#", " ", " ", "#", "#", "d", "d", "d", "#", " ", " ", "B", " ", " ", "B", " ", " ", "#", "F", "d", "d", "#", "#", "A", "A", "#", "#", " ", "#"],
        ["#", " ", "#", "p", " ", " ", "p", "#", "#", "#", "#", "#", "C", "C", "B", "C", "C", "B", "C", "C", "#", "#", "#", "#", "#", "p", " ", " ", "p", "#", "A", "#"],
        ["#", " ", " ", " ", " ", " ", " ", " ", " ", " ", " ", " ", " ", " ", " ", " ", " ", " ", " ", " ", " ", " ", " ", " ", " ", " ", " ", " ", " ", " ", " ", "#"],
        ["#", " ", " ", " ", " ", " ", " ", " ", " ", " ", " ", " ", " ", " ", " ", "B", "B", " ", " ", " ", " ", " ", " ", " ", " ", " ", " ", " ", " ", " ", " ", "#"],
        ["#", " ", "#", " ", " ", " ", " ", "#", "#", "#", "#", "#", "C", "C", "B", "A", "A", "B", "C", "C", "#", "#", "#", "#", "#", "B", "B", "B", "B", "#", " ", "#"],
        ["#", " ", "#", "#", "h", "d", "#", "#", "p", "p", "p", "#", "p", "B", "A", "d", "d", "A", "B", "p", "#", "p", "p", "p", "#", "#", "d", "p", "#", "#", "d", "#"],
        ["#", " ", " ", "#", "d", "h", "#", "h", "p", "d", "p", "p", "B", "A", "d", "h", "h", "d", "A", "B", "C", "p", "d", "p", "h", "#", "h", "d", "#", "c", "d", "#"],
        ["#", "#", "#", "#", "#", "#", "#", "#", "#", "#", "#", "#", "#", "#", "#", "#", "#", "#", "#", "#", "#", "#", "#", "#", "#", "#", "#", "#", "#", "#", "#", "#"]
    ]
}