{
    "map": [
        ["#", "#", "#", "#", "#", "#", "#", "#", "#", "#", "#", "#", "#", "#", "#", "#"],
        ["#", "a", " ", " ", " ", " ", "b", "#", " ", " ", " ", " ", "A", " ", "h", "#"],
        ["#", "#", "#", "#", "#", "c", "#", "#", " ", "#", "#", "#", "#", " ", " ", "#"],
        ["#", " ", " ", " ", " ", " ", " ", "#", "B", "#", "F", "A", "#", " ", " ", "#"],
        ["#", " ", " ", " ", " ", " ", " ", "#", " ", "#", "#", " ", "#", " ", " ", "#"],
        ["#", " ", " ", " ", " ", " ", " ", "#", " ", " ", "#", " ", "#", " ", " ", "#"],
        ["#", " ", " ", " ", " ", " ", " ", "#", "#", " ", "#", " ", "#", " ", "p", "#"],
        ["#", " ", " ", " ", " ", " ", " ", "C", " ", " ", "#", " ", " ", " ", "p", "#"],
        ["#", "#", "#", "#", "#", "#", "#", "#", "#", "#", "#", "#", "#", "#", "#", "#"]
    ]
}